#######################################################
#.......#.......*********************************@****$
#####...#....#.##.....#..##############.....###.......#
#......#....#.##......#..##**#..#.....#...#........#..#
####.#....#...######..#.#.#..#.....#..#.*.*.*.*########
#..#....#..#....####.*#..#..###*#####..##....#..#...#.#
#....#.....####.......#**..#...*...#.#.*#.##...#.######
#*########.#.*.#.*.#.#.#..##.#.*.*.*.*#..#.....#.#~~~~#
#............#..######...#..###.....*..#..#....#.#~~~~#
#######.##****...*#...*......##*#####...#..#...#.#..*##
#~~~~~~~~~~~~~~.~~#........#........#...#*.#...#.#.#..#
#****************~~*****.........#~#~#~#~#.#~#~#.#..#.#
#.......*...##.#############..*#.......#............#.#
#..~~~~.#..#..#....*#............##~#*~#~#~#~#~..#....#
#..##~#~#~#~#...###.#.#..######.#####...***.#...#.#.#.#
#..#...#........#.#..******...#.....*...#......#..#####
#....*.......~~~~~~....#.#.#.##~~~~~~~~*.*.*.###.#.####
#######################################################