#########################################################
#........#.......#......**....*......*.........####.....#
#####..........##.......############........###.........#
#.......#.....##.........##******.....#...*...#.........#
#.###.*....#...######....#.#.#.##........*.*.*.*.*.*.*..#
#..*....*..#....####.***...*.....*...#....#....#........#
#.#..#..#...####........*...*...*...#...*..##...........#
#...#.*.#.*.#.*.#.*.#.#.*.#.#.#.*.*.*.*.................#
#.............#########......###.....*..................#
#######......*...*....*......########...................#
#.......**.......#........#............#*...............#
#.####.******************.........#.#.#.#.#.#.#.#.......#
#.....*....*****.#############..*......**..@...~........#
#........#..#..#....#..................####.............#
#####.......#...#.....#..############.........#**.......#
#.......#.......#.......##********.....#...*...#........#
#.###.*.......######....#.#.#.##........*.*.*.*.*.*.*...#
#########################################################