........#....
#####........
.......#.....
@###.*.......
.............
...****......
.............
.............