#######################################################
#.......#.......**************************************$
#####...#....#.##.....#..##############.....###.......#
#......#....#.##......#..##**#..#.....#...#........#..#
####.#....#...######..#.#.#..#.....#..#.*.*.*.*########
#..#....#..#....####.*#..#..###*#####..##....#..#...#.#
#....#.....####.......#**..#...*...#.#.*#.##...#.######
#*########.#.*.#.*.#.#.#..##.#.*.*.*.*#..#.....#.#~~~~#
#............#..######...#..###.....*..#..#....#.#~~~~#
#######.##****...*#...*......##*#####...#..#...#.#..*##
#~~~~~~~~~~~~~~.~~#........#........#...#*.#...#.#.#..#
#****************~~*****.........#~#~#~#~#.#~#~#.#..#.#
#.......*...##.#############..*#.......#............#.#
#..~~~~.#..#..#....*#............##~#*~#~#~#~#~..#...@#
#..##~#~#~#~#...###.#.#..######.#####...***.#...#.#.#.#
#..#...#........#.#..******...#.....*...#......#..#####
#....*.......~~~~~~....#.#.#.##~~~~~~~~*.*.*.###.#.####
#######################################################