........#.......#......**....*......*.........####......
#####..........##.......############........###.........
.......#.....##.........##******.....#...*...#..........
.###.*....#...######....#.#.#.##........*.*.*.*.*.*.*...
#..*....*..#....####.***...*.....*...#....#....#........
.#..#..#...####........*...*...*...#...*..##............
...#.*.#.*.#.*.#.*.#.#.*.#.#.#.*.*.*.*..................
.............#########......###.....*...................
#######......*...*....*......########...................
.......**.......#........#............#*................
.####.******************.........#.#.#.#.#.#.#.#........
#.....*....*****.#############..*......**..@............
........#..#..#....#..................####..............
#####.......#...#.....#..############.........#**.......
.......#.......#.......##********.....#...*...#.........
.###.*.......######....#.#.#.##........*.*.*.*.*.*.*....